1111111111
1P001CC001
10001CC001
1E00111001
1000001001
100C001001
1000000001
1000001111
1C000C1
1111111
